snr
{don't use Chinese;
any \r\n and blank would be ignore.
}
#################
#...   o     a	#
#               #
#      @        #
#               #
##             ##
#              
##...          ##
#          .....#
#      h        #
#     ..        #
#				#
#				#
#################